............................................................................
............................................................................
............................................................................
............................................................................
............................................................................
..p.........................................................................
............................................................................
............................................................................
............................................................................
............................................................................
.........................5..................................................
.................11111111111111111..........................................
........11111.........................11111.................................
............................................................................
1111111111111111111111111111111111111111111111111111111111111111111111111111
............................................................................
............................................................................
............................................................................
............................................................................
............................................................................